@     @@@    @
@  @@@@@@  @@@
@  @@        @
           @@ 
@          @  
@          @  
 @@   @@    @@