#     ###    #
#  ######  ###
#  ##        #
           ## 
#          #  
#          #  
 ##   ##    ##