#     ###    #
#  ######  ###
#  ##        #
           #    # 
#          #  
#          #  
 ##   #    ##